a whit = un brin
not a whit of difference = pas la moindre différence
Whit = Pentecôte
not a whit = pas un brin
overhead = au-dessus, aérien, vertical
overhead costs = frais généraux
boilerplate = expression passe-partout, standard
boilerplate code = code standard
to cobble together = bricoler
cobbles = pavés
to interleave = entrelacer, imbriquer
pace = rythme, allure
to pace up and down = faire les cents
to pace (around) = arpenter
to pore over = lire très attentivement, étudier de près
to pore = méditer longuement
every nook and crany = le moindre recoin
a nook =  un recoin
spurious = faux, infondé
predicate = prédicat, élément central, principal (en grammaire, d’une phrase)
buffer = tampon
buffer memory = mémoire tampon
to pertain to sth = avoir trait à qch
to pertain = dépendre de, se rapporter à
to pertain to = relever de
to unclog = déboucher, désengorger
a sneer = un ricanement
to sneer = ricaner, sourire d’un air sarcastique, se moquer
to sneer at sb/sth = se moquer de qn/qch avec mépris
cruft = superflu
to sidestep = éluder, éviter, esquiver
a whim = un caprice
on a whim = sur un coup de tête
blither = joyeux
blitherly = gaiement
a wrinkle = un pli, une ride
to wrinkle = rider, froisser
to wrinkle one’s brow = froncer les courcils
conceit = vanité, suffisance
the dregs of (worst part) = la lie de
the dregs of society = la lie de la société
anathema = anathème (malédiction, excommunication)
blurb = baratin, bla-bla
seldom = rarement
weasel = belette, fouine
sojourn = séjour
a plea = un plaidoyer, un appel, une réclamation
plea deal = arrangement
to pat = caresser, donner une petite tappe
pat = simpliste
to know something of pat = savoir qch par coeur
to wield = manier, brandir
a crutch = une béquille, un soutien, entrejambe
to daunt = intimider
gaunt = décharné, désolé
liability = responsabilité, passif
limited liability company = société à responsabilité limité
clumsy = gauche, maladroit
struct = structure
seminal = phare, séminal (relatif au sperme)
seminal book = ouvrage fondateur
thorny = épineux
to mock = feindre, simuler, imiter, se moquer
a stub = un mégot, bout, talon
to stub out = écraser
a pay stub = feuille de paie, buletin de salaire
treacherous = périlleux, déloyal, dangereux
one-off = unique
a one-off payment = un paiement en une seule fois
a parser = un analyseur
to parse = analyser, décrypter
to mumble = marmonner
a mumble = un marmonnement
a hood = une capuche, un capot
extractor hood, vent hood = hotte aspirante
under the hood = sous le capot
a rudder = un gouvernail, un palonnier
rudderless = à la dérive, sans gouvernail, sans direction
to clutter up = encombrer
clutter = fouillis, fatras
clutter rejection = élimination des signaux parasites
herein in this book) = en ceci, dans le présent texte
crusty = croustillant
a vent = une fente, une conduite d’aération
to vent = passer
dangling = suspendu, pendant-e, ballant
to postpone = reporter
to refine = améliorer, raffiner, améliorer
a bevy of = une bande de
a scramble = une bousculade, une lutte
to scramble = avancer péniblement, brouiller
amidst = parmi, au milieu
cue = signal
on cue = au bon moment
to rot (away) = pourrir
muddle = pagaille, désordre, fouillis
to muddle = brouiller, embrouiller
to muddle along = aller son chemin tant bien que mal
to muddle through = se débrouiller
to hop = sauter
stake = enjeu, mise, participation
to stake = miser, mettre en jeu
stale = rassis, éculé, rebattu
stale software = logiciel périmé
throughput = débit, flux de production
to beg = mendier, quémander, supplier, prier
compliance = conformité, docilité
to regain compliance = se remettre en conformité
outright = sur le coup, carrément, total
to be killed outrigth = être tué sur le coup
a rip = une déchirure
to rip = déchirer, arracher
to rip off = arnaquer, arracher
a rip-off = une arnaque, une copie
heuristic = heuristique (règles de la recherche scientifique)
sour = aigre, acide, tourné, acerbe
to grind = moudre, écraser, hacher
to grind out = abattre
to taint = gâter, dénaturer, entacher
cork taint = goût de bouchon
festering = purulent, suppuration
cork = liège, bouchon de liège
to fester = suppurer
to elide = élider, ignorer
to ought to = (modal) devrait, doit
a mangle = essoreuse, mangle, calandre (machine à cylindre)
a fiddle = un violon, une combine, une escroquerie
to fiddle = falsifier, truquer, jouer du violon
to fiddle with = tripoter
to play second fiddle = jouer les second rôles
itch = démangeaison
to itch = démanger, gratter, avoir des démangeaisons
clover = trèfle
four-leaf clover = trèfle à quatre feuille
reams of = des pages et des pages de
a ream = une rame (de papier)
to write reams = écrire des tartines
a ramble = une randonnée
to ramble on = déblatérer, radoter
to ramble = radoter
stretch = étendue, période
to stretch = détendre, assouplir, étirer
ilk = genre, acabit, espèce
of that ilk = du même gabarit
a wince = une grimace
to wince = grimacer, tressaillir
to foreshadow = annoncer, préfigurer
unit test = test unitaire
to assert = affirmer, faire valoir
a quibble = une objection
to quibble = ergoter, chicaner
to quibble with sth = ne pas être d’accord avec qch
to marshal = rassembler, canaliser, mobiliser
to marshal support = mobiliser l’appui, réunir le soutien nécessaire
stakeholder = partie prenante, intervenant, acteur, intéréssé
resort = recours, station de vacance
holiday resort = station touristique
to resort to = recourir à, avoir recours à
seaside resort = station balnéaire
resort town = ville de villégiature
miscellaneous = divers, varié
the yield = le rendement, la production
to yield = rapporter, produire, céder
dividend yield = rendement d’une action
a clerk = un employé de bureau, une réceptioniste, un secrétaire, un commis
to inundate = inonder
to obfuscate = obscurcir, noyer le poisson, masquer, brouiller
to stumble = trébucher, tituber
to stumble across/on = tomber sur
a clump = un massif, un bouquet, une motte, une touffe
crop = culture, récolte
to crop = tondre, brouter
root crop = tubercule
to crop up = survenir, se présenter, arriver de façon imprévisible
slope = pente, versant, inclinaison
sloppy = peu soigné, bâclé, négligé
to poke = piquer, pointer
a poke = un petit coup
to poke about = fouiner, fourrager (fouiller en mettant en désordre)
to forage = fourrager (fouiller en mettant en désordre)
the forage = le fourrage
ingot = lingot
to nit-pick = chercher la petite bête
nit-picker = pinailleur
a nit = une lente (poux), un imbécile/idiot
lice and nits = poux et lentes
hither and yon = ici et là
hither = ici, de ce côté ci
haste = hâte, précipitation
to ferret about = farfouiller, fureter dans
to ferret out = dénicher
a ferret = un furet
compelling = incontestable, irréfutable, fascinant
to tangle up = s’emmêler
a tangle = un enchevêtrement
a defect = un défaut
to defect = s’enfuir
hearing defect = défaut de l’ouïe
without defect = sans faille, sans défaut
a riddle = une devinette, une énigme
to speak in riddle = parler par enigme
subroutine = sous-programme
to bloat = gonfler, ballonner, boursoufler
sheer = pure, très fin, abrupte, à pic
a sheer rock face = un pic abrupt
to sheer away = éviter
sheer power = puissance brute
hodgepodge = mélange, fourre-tout, méli-mélo, fatras, salmigondis
to jig about = se trémousser
jig = gabarit, calibre, montage
to hamper = gêner, entraver, contrarier,
a picnic hamper = un panier (d’osier)
a scruffle = une échaffourée, une rixe, une bagarre
to scuffle = se bagarrer
proxy = intermédiaire, procuration, mandataire
excruciating = atroce, insupportable, torturant
to excruciate = torturer
to delve = fouiller
to delver into sth = fouiller dans qch, explorer qch
to shuffle = battre, remuer, traîner (les pieds), brouiller
to scatter = éparpiller, disperser
scatter plot = nuage de points
hick = plouc, péquenaud
hick town = trou paumé, bled paumé
padding = rembourrage, remplissage
to annoy = ennuyer
nethertheless = néanmoins
outdated = dépassé
wand = baguette magique
riddle = énigme
demise = disparition
to brag = se vanter
security protocol = protocole de sécurité
comb = peigne
to patter = crépiter
taste infusion = infusion de goût 
lungs = poumons
to wander = errer, vagabonder, s'égarer
wanderer = vagabond, errant
rover = vagabond, vadrouilleur, nomade
nomade = nomade
gadabout = vadrouilleur
vagrant = vagabond, errant, clochard
loater = vagabond
pleasure-seeker = jouisseur, hédoniste, qui recherche le plaisir
beggar = mendiant, gueux
ragamuffin = galopin, un enfant dans des vêtements sales et pauvres
to beggar = appauvrir, ruiner
a hobo = clochard, vagabond, chemineau
to wrench = tirer violement, torturer, un coup violent et soudain
a wrench = clé (ex = clé anglaise), mouvement violent de torsion, entorse, déchirement
to snatch = avaler à la hâte, arracher, saisir, dérober, s'emparer de
seizing = saisissant
to seize = s'emparer de, saisir, prendre, capturer, confisquer
at the turn of = au tournant de 
to roam = errer
glimpse from hell = aperçut de l'enfer
to enhace = améliorer
oath = serment
to come to harm = faire mal
boundary = borne, frontière
especially = notamment, particulièrement
notably = notamment, remarquablement
agnostic = agnostique
a site that brings together a large community = un site qui rble une gde communauté
documentary = documentaire
relevant = pertinent, approprié
stealth = furtif, infiltration
fancy = recherché, raffiné, extravagant, fantasme
fanciful = capricieux, fantasque, fantaisiste
faintness = faiblesse, légèreté
faint = faible, léger, éteint
i have not the faintest idea
to feel faint = se sentir mal, pris de malaise
to farrow = mettre à bas
bakery, baker's, bakeshop = boulangerie
to fare = réussir, voyager
fare = tarif, prix du billet, gamme de nourriture particulière (ex = provencal fare)
a range of = une gamme de 
range = portée, gamme, distance, direction, alignement
to range = aligner, mettre en rang // parcourir, vagabonder
to grasp = saisir, s'emparer de, -> comprendre, saisir
to grasp the importance of smt = saisir l'importance de qqch
against the grain = à contre-fil
it goes against the grain of him to = ce n'est pas dans sa nature d'admettre que
a tramp = un clochard
gamely = vaillamment, courageusement
gamble = pari, coup de poker
to gamble = jouer
gambling = jeux d'argent
gambling on the stock exchange = la spéculation en bourse
galore = en abondance, à gogo
gambit = (fig) tactique, stratagème, (checkers) sacrifice volontaire d'un pion
to garble = dénaturer, embrouiller, déformer
a garbled message = un message confus
rough-and-tumble = situation sans règles, un chacun-pour-soi
abashed = confus, cause de se sentir embarrassé, honteux
disconcerted = déconcerté
to unsettle = ébranler, troubler, déranger, cause to feel anxious, uneasy, disturbed
to settle = s'établir, apaiser, mettre fin, dissiper, résoudre
a nest = un nid, un abri, un set d'object similaires de taille croissante (ex = a nest of tables)
to nest = nicher
gale = coup de vent, grand vent
gale-force winds = vents forts
gangplanck = passerelle
gangway = passerelle, allée (exclam) dégagez le passage!
gamut = gamme
to seek = demander, chercher, ambitionner, tenter de trouver qqch
to attempt to +bv = tenter/essayer de faire qqch
bespoke = fait sur mesure
bespatter = (fig & litt) éclaboussures
bespattered with mud = tout maculé de boue
to besmirch = (fig & litt) souiller
to besmirch somebody's name = souiller le nom de qqn
to besiege = assiéger, assaillir,harceler
besotted = épris, fou
besotted with drink = abruti par l'alcool
to be besotted with something = adorer qqch
to be besotted with someone = être follement épris de qqn
woe betide him = (litt) malheur à lui !
betrothed = promis, fiancé
betrothal = fiançailles
to beseech (besough besough) = supplier, implorer, solliciter
benign = doux, clément, affable
bidding = enchères
binding = liaison
to bind (bound, bound) = lier, attacher, bander, agglutiner
binder = liant, agglomérant
bound in leather = relié de cuir
dew = rosée 
eyelashes = cils
to lash = fouetter, fustiger, réprimander 
lash = lanière, corde, mèche
wick = mèche // hamlet, town, district // ordure
to wick = absorber ou retirer un liquide par capillarité
forcibly = forcément, par la force, énergiquement, avec vigueur, en utilisant la force
to entail = comporte, entraîne
to arouse = susciter, éveiller, exciter
to lurk = rester derrière, se cacher, rôder
rubbish = ordures
garbage = ordures, déchets
odd = bizarre, singulier
awkward = embarrassant, malaisé, gênant, maladroit
to what extend = en quelle mesure
to ensure = assurer, garantir
although = bien que
to relish = savourer, goûter
relish = saveur, goût, attrait
once in a lifetime = une fois dans une vie
exposure = exposition, mise à nu, scandale
to stick to one's routine = s'accrocher à sa routine
after all = après tout
in recent time = dans un passé proche (!!!)
a matter of outlook = une question de point de vue
it's a matter of context = c'est une question de contexte
to pile up = s'amonceler, s'entasser
civil unrest = troubles civils
ashed = réduit
wisdom = sagesse
praise = louange
vocabulaire "invictus" william ernest henley, 1875
unbowed = insoumis face à l'oppression, à la demande.
pit = la fosse
from pole to pole = d'un pole à l'autre
fell (adj) = cruel, terrible
fell (nom) = colline 
to clutch = empoigner, agripper
to fall into [sb]'s clutches = tomber dans les griffes de [qqn]
clutch = embrayage, étreinte, prise / couvée 
circumstance = circonstance 
to wince = grimacer de douleur
to bludgeon = matraquer
wrath = courroux, colère
punishment = châtiment 
to loom = se dessiner, se profiler, apparaître
to loom up = surgir, apparaître (négatif)
apparatus = appareil
to swipe up = balayer vers le haut
lair = repaire
notch = entaille, encoche
shrewd = astucieux
to hail from = provenir de (origin, home)
hail = la grêle
to hail = héler, saluer
hardy = robuste
nimble = agile
treacherous = perfide
wrist = poignet
brew = brassage
brewing = brassage
brewing ale = brasserie
ale = bière ( de fermentation haute)
beer = bière
slush = gadoue, neige fondante
uphill = la montée, le montant, amont -> difficile, ardu
shepherd = berger
to lead = conduire
trout = truite
dye = colorant
dyeing = teinture
to coerce = contraindre
to boast = se vanter
wedge = coin
to wedge = forcer dans un espace étroit, caler, coincer
riddance = débarras
bonemeal = farine d'os
to strew = parsemer
to litter = joncher
foremost = avant toute chose
to slain = tuer de façon violente, massacrer 
to rid = débarrasser
fancy pants = (exp) supérieur ou de haute société, (con) négative et prétentieuse
to bargain = négocier, marchander
fence = receleur, barrière
dope = drogue
stare = regard
to stare at = regarder fixement, regarder les yeux écarquillés 
waist = taille, reins
ribs = les côtes
hips = hanches
pedestal = piédestal
ordeal = supplice
cheeks = les joues
crotch = fourche
cupboard = placard
snitch = mouchard
maiden = jeune fille, vierge
spear = lance
whip = fouet
reluctant = réticent
stretch = étendue
sketch = croquis, esquisse
disorder = désordre
misdeed = méfait
worship = culte
to worship = adorer, vénérer
curfew = couvre- feu
to herd = conduire, mener
herd = troupeau
shivering = tremblant, frissonnant
to shiver = trembler
to slap = gifler
wise = sage
wisdom = sagesse
wisely = judicieusement
cranky = farfelu, excentrique
spire = cime, aiguille, flèche
shipwreck = naufrage, épave de navire
wreck = épave, ruine, accidents, décombres
crippling = paralysant, handicapant
to cripple = paralyser, handicaper, entraver
bind = liaison
to bind = attacher, lier
to pull = traîner, tirer, retirer
pull = traction, attraction, épreuve
mournfully = malheureusement
to mourn = pleurer, se lamenter, faire deuil
to seek = chercher, tenter, ambitionner
eager = désireux, avide
earshot = portée d'oreille, distance à laquelle on peut entendre/ être entendu
burden = charge, fardeau, poids
shrine = tombeau, mausolée 
backfire = pétard, raté
prank = farce, tour (plaisanterie)
to fetch = chercher puis rapporter, rapporter
rug = couverture, carpette
rugged = robuste, rugueux, déchiqueté 
friendzy = amical
likewise = aussi, également, pareillement
wares = marchandises
sleeve = manche, chemise
mischief = tort, sottises
mischievous = malin, méchant, nuisible
wallop = coup, fracas, boucan, taloche
to wallop = cogner, donner un grand coup
shin = tibia
undergo = subir, endurer
to dodge = esquiver
contrivance = engin, invention, stratagème
wrath = courroux, colère divine
wraith = spectre, apparition
full-fledge = à part entière
feather = plume, vêtements, habits
grove = bosquet
acquaintance = relations, connaissance
harsh = dur, sévère, méchant 
coward = lâche, poltron
inn = auberge
blanket = couche, nappe, couverture
coarse = grossier, rude, vulgaire
offery = offre
trifle = bagatelle, broutille, diplomate
to trifle with = agir frivolement, gaspiller son temps, traiter avec irrespect
redeem = racheter, compenser, réparer
redeemer = rédempter
rood = crucifix
wafer = ostie
wield = user de, manier, exercer
perks = avantages
salvage = sauvetage, récupération
acquaintances = connaissances, relations
to withdraw = se retirer, se désister, se rétracter
to cease = cesser, s'arrêter, faire cesser
cease = rupture
eel = anguille
thrust = poussé, initiative, dynamisme, coup ( de couteau )
to thrust = fourrer, plonger, enfoncer, 
intervenir, donner un coup de couteau
thrusk = précipitation ( luxembourish )
rainfall = précipitations
hauling freight = transportant du freight
haul = distance à parcourir, butin, quantité de choses possédées illégalement 
to haul = transporter (véhicule) camionner, tirer, trainer (personne)
to pull = tirer, traîner, enlever, retirer, vider
pull = traction, attraction, poignée, gorgée
coupling = attelage
lure = appât, leurre
to lure = tromper, attirer par la ruse
to rustle up = se débrouiller pour trouver, faire préparer à la hâte
rustle = bruissement, froufrou 
to rustle = produire un froissement, faire bruire, agir rapidement et énergiquement, voler
to hustle = s'engager dans la prostitution, faire le trottoir, forcer, presser, bousculer
hustle = grande activité, bousculade, tourbillon, racket, fraude
whirlwind = tourbillon, tornade
swirl = tourbillon, remous, volute
to swirl = tourbillonner, tournoyer
backwash = remous
drag = entrave, frottement, frein, boulet, trainée, araignée
to drag = traîner, être en retard, inhaler de la fumée
(... is )a drag ; personne ou chose ennuyeuse
to expel = exclure, chasser, renvoyer, évacuer
to deprive = priver, dépouiller, déposséder
to deny = nier, priver, refuser, démentir
lift = ascenseur, vol (avion), cargaison, assistance, aide
to lift = plagier, abolir, dissiper, soulever, transporter, évacuer
uneven= inégal, irrégulier, impair
tilt = inclinaison, pente, attaque, couvercle, vitesse, joute
to tilt = incliner, pencher, rabattre
mortgage = emprunt, prêt, hypothèque 
outfitter = 
to outfit = équiper
outfit = tenue, équipement, attirail, habits, matériel
bunk = couchette, couche, abusrdité
to bunk = camper
nonsense = absurdité, sottises, balivernes, inepties.
mundane = terrestre (par opposition avec ce qui vient du ciel), banal, quelconque
to hail = saluer, héler
hail = pluie, grêle
roundabout = manège, indirect, détourné
to idle = tourner au ralenti, paresser, fainéanter
idle = inoccupé, au  chômage, vain, inoccupé, sans but
pointless = inutile, vain, gratuit, idiot, sans objectif
swollen = gonflé, enflé, accrue
unyielding = inflexible
 to thump = cogner, frapper, tapper, battre, marcher à pas lourd
thump = grand coup, bruit sourd
hide = peau, cuir, cachette
hence = d'où, par conséquent
fang = crochet, croc
fool = bouffon, idiot, abrutit
to fool = tromper, duper, faire l'imbécile
slit = fente, incision
shrewd = astucieux, habile, perspicace, cruel
nimble = preste, adroit, habile, leste
smirk = petit sourire satisfait
anguish = angoisse, souffrance, supplice
distress = misère, chagrin, péril, pauvreté, détresse
rod = bare, bitte, canne, perche, 
equalizer = flingue, revolver.
monsoon = mousson
to squirm = se tortiller, se convulser
to wriggle out of doing something = se défiler et ne pas faire qqch
to wriggle = se tortiller, frétiller
to wrinkle = rider, plisser
to wrinkle one’s brow = froncer les sourcils
milestone = étape importante, borne kilométrique
to muffle = emmitouflér, étouffer 
dusk = crépuscule, noir, obscure
to wreck = détruire, anéantir
a twig = une brindille, une branchette
foresaken = abandonné
to boast = se vanter, se glorifier d’avoir
boastful = vantard
buffering statements
hallmarks = poinçons
attuned = à l’écoute 
to attune = accorder, mettre à l’unisson 
elbowed = coudé
awkward = gênant, inconfortable 
afterthought = après coup
blunt = émoussé, cru, 
callous = calleux, insensible, sans cœur 
obfuscate = dérouter, déconcerter
contentious = querelleur, chamailleur
pugnacious = pugnace, batailleur
up to snuff = à priser
flaunt = s’exhiber, faire étalage de 
notwithstanding = nonobstant, malgré 
hints = allusions, astuces
enforce = imposer, mettre en œuvre 
demeanor = comportement, conduite
congenial = (a qqn) agréable, sympathique 
outermost = le plus à l’extérieur 
forthright = direct, franc
to compromise = accepter le compromis
uncompromising = sans compromis
in the sake of = dans le but de 
to infer = laiss. entendre, insinuer, déduire
tangible = tangible, perceptible 
deposit = un dépôt, une caution 
to strive = s’acharner, s’évertuer, s’efforcer 
group striving = les efforts du groupe
broad = vaste, grand, large, général 
a bolt hole = un refuse
to hole up = se cacher, se terrer/planquer 
snafu = confusion, cafouillage, désordre
to recount = raconter, retracer, narrer
socialy ill-at-ease = mal à l'aise socialemnt
to assert = affirmer
to assess = estimer, évaluer 
an assessment = évaluation, estimation
meanwhile = entre temps, pendant ce tps
to stare at = fixer du regard
to startle = surprendre, étonner, faire peur
peanut = cacahuète
to wave someone over = faire signe à qqn
to reflect = réfléchir, renvoyer 
sparingly = avec parcimonie 
gauge = jauge, calibre, gabarit, mesure
crap = merde, foutaise 
understatement = euphémisme, littote
softener = adoucissant 
downright = carrément, franchement 
to magnify = amplifier, grossir, exagérer 
to minimize = réduire, minimiser 
to sprinkle = saupoudrer, parsemer 
to ease into = se glisser dans 
a stating = une déclaration 
for whatever it is worth = pr ce que ça vaut
to diagnose = diagnostiquer
to pinpoint = préciser, mettre le doigt sur
carrer fairs = salons des carrières
extensive = étendu, extensif
supplier = fournisseur
to fast-track = accélérer le dev/progrès de
fast-track = voie rapide
he was caught completely off-guard = il a été pris complètement au dépourvu
off-guard = au dépourvu
candor = candeur, franchise, sincérité 
vitriol = vitriol, critique mordante
thorough = profond, approfondi, minutieux
thoroughness = ampleur, minutie
outline = contour, profil, tracé, esquisse
to outline = souligner, esquisser
cautious = prudent, précautionneux 
succinct = succinct, concis, court
dress conservatively//dress casually
forcefully = avec force
genuine = véritable, réel, sincère, authentique
straight-shooter = (person) honnête, direct
overt = déclaré, franc, non déguisé
to rub = frotter
the squeaky wheel gets the grease = (prov) les + gros pbs sont ceux qui attirent le + l’attention.
inconsistent = incohérent, inconséquent
to rollout = sortir (produit, nouveauté)
to test-drive = faire un essai
self-conscious = timide, complexé
meek = doux, humble
assertiveness = assurance, affirmation de soi
deferential = respectueux 
deference = respect, soumission
outwardly = extérieurement 
outward = vers l’extérieur 
ward = quartier, pavillon
a beacon = une balise
disclosure = révélation, divulgation 
to advocate = plaider, défendre 
directness = franchise, authenticité 
to restrain = retenir, contenir, maîtriser 
assertive = assuré, péremptoire 
to interfere = immiscer, intervenr, interférer
implied = sous-entendu 
to understate = minimiser, réduire l’imptce
to exaggerate = exagérer, amplifier, grossr
proxemics = proxémique (the study of human use of space and the effects that population)
lost in translation = traduire c’est trahir
nought = rien, néant
saddle = une selle
to unstaple = dégrafer
semicolon = point-virgule (;)
the remainder = le reste
fluency = (avec) aisance, facilité 
to hone = aiguiser, (fig=améliorer)
the laundromat = la laverie 
miscellaneous = divers, varié
mandatory = obligatoire
